{
	"height": 11,
	"layers": [
			{
				"data": [4, 3, 4, 3, 4, 3, 4, 3, 4, 3, 4,
						 2, 5, 1, 0, 1, 0, 2, 0, 1, 0, 2,
						 4, 1, 4, 3, 4, 1, 4, 1, 4, 1, 4,
						 2, 0, 2, 0, 2, 0, 1, 0, 2, 0, 2,
						 4, 1, 4, 1, 4, 3, 4, 3, 4, 1, 4,
						 2, 0, 2, 0, 1, 0, 1, 0, 1, 0, 2,
						 4, 1, 4, 3, 4, 1, 4, 3, 4, 1, 4,
						 2, 0, 1, 0, 1, 0, 2, 0, 1, 0, 2,
						 4, 3, 4, 3, 4, 1, 4, 1, 4, 3, 4,
						 2, 0, 1, 0, 1, 0, 2, 0, 1, 6, 2,
						 4, 3, 4, 3, 4, 3, 4, 3, 4, 3, 4],
				"height": 11,
				"name": "Level 1",
				"opacity": 1,
				"type": "level1layer",
				"visible": true,
				"width": 11,
				"x": 0,
				"y": 0
			},
			{
				"height": 11,
				"name": "objects",
				"objects": [
					{
						"gid": 16,
						"height": 0,
						
						}]
				}],

}